#####################
#...B.....D.........#
#...B.....D.........#
#..@#OOOO##.........#
#...#xB..@#.........#
#####################