###########
#...B.....#
#...B.....#
#..@#OOOO##
#...#....@#
###########